gnw: uxr bmk vsc
sob: iya tiy xbi ruc
axt: sob
bti: gsg
ugc: cib pez hpi wgn nug ukc qca qib cwi kcg pfk khk thm lms bde zhx gem skx geo tsj akm
nub: wku
cyi: twx vhh aox
vpy: yyp mkf atp hlf
iqt: out
gve: izs
azy: smo tbr tth
gem: cyi dac
usf: vzc lup jlh emj
xno: euv xjp fuy
cge: jsa
aer: aum pvs bpf
gqw: vph
hzx: wmi gjo
wkr: lod mwe
eak: cfy
xvy: oek
ujv: wrk qdb yea
tth: adr
phi: xvy
jwn: wjy qey rwt ssy
orm: qtr rib myl
hvw: orm bsr
onm: eak
tiy: tkj dbf
ewm: qlt bbp
bvg: ugp knv kvi
kck: lil
wax: vzc bgf lup emj
krd: fip anr
qey: riy jry dqi ojn jam sxc obg
lxc: gsg
hka: lmb gac
jvi: dqw hrv
aoj: ehb zjj onk
kzb: pzt
uxk: wjy rwt ssy qey
fsz: ulv cet egd
wav: wjy
qbu: jwn wav
ely: ork yjf
ntq: hrf yqq xfe
adi: gac lmb
you: mgj bqh ewm mtt xzg vfx fkw ihm tri
ehb: kpa jzq hnv
rtr: umd bfm
jlh: cmu khw
ezv: pxe
bks: kwd wku
smo: qby gsg
mlv: gac
bpi: ssy rwt wjy
yxa: out
ojb: hvw
kzm: hwr fdu
hwb: atp
gjo: oer efm zgj qgz lmn tbf fkw yke ntl
zli: ape pjt evq
tjq: qbd vsa zst
fqu: xhg sjl
uya: nfd
ksp: gsg adr
mbw: bff
vfx: wax
ubk: adr
vsa: gve
pez: mlr lpp bvg
blf: sjl
vlm: qvt ugc xhg sjl
gid: wjy qey ssy
axl: wjy qey ssy rwt
lyl: lah
cxv: cqu rgc vws
wku: you wmi guf
ulv: wjy rwt
amm: guf gjo wmi you
bmk: out
lmb: fbf eqj zlq tjq byu qzq ikr
ikr: qbd
xzg: flz krd
exw: out
kuu: gwj
cok: drq ujy hzx
emj: sip cmu
kke: qby
mgj: rtr zbn
zgj: usd xno ynk
etc: gnx
vwl: tcn hsj
kvi: wmi
lol: efs tdi fqu ugd eqt
fko: pvs kgv
uzi: qdb yea jvi
aly: fuy
qmo: nbu bti jvn
cll: cmc gnx
yze: ofu pvs aum
wds: xln swf ugl
mgb: gwi mll isc krl
tcx: wrk jvi qdb
ojs: frt
elw: nui zhv stf
sip: vtt
zyp: rxq lah isz
cbg: out
vsc: out
dyf: zbk dxn wxk
bvs: you gjo wmi guf
yby: vsc bmk
phe: vrx dah scd
lzu: mcy ind
zlq: vks
qes: hwr nvi
dqw: ytr tau hka uia
tao: qbd zst
zbk: out
mtt: vla zbn
ugl: scp dyf
tnc: oew
hhk: twx haz bbu
iaj: out
fus: ugp kvi
efs: sjl ugc dci qvt xhg
jsa: qey ssy rwt wjy
awj: rjr
fkw: mgb yfb
giw: xwp
gzk: ate
ntl: usf wax
jam: jvi yea
gqg: uia hka ytr
egd: qey rwt
vrx: xty syn
ety: dtn
eyy: wku kwd amm
dnn: rgc cqu rkc
xwp: lmb omm gac
gwj: rlu ium
lla: adr
sjl: skx zhx tsj geo qca hpi wgn nug pez cib bde lms cwi pfk
azi: lla uze fmv
rkc: jex cpz
xaf: evu sfv eyy bks
isz: jya wgh
oak: ugm nfn why yre zyp dnn fbl hfd
syn: qmo hsn
fbf: gzk vks
jry: jvx
knv: you gjo
ugm: rxq
uak: nfd
pfk: idr usz kbl
rfe: hnv kpa
hfd: mbw uwe
dtn: giw ruc iya
trn: dsz swr
wlh: qhp yxa uld eyf
aas: yzn qsm
uoj: zie
ahn: nyr hzx
bgf: khw
mxl: yax wav
lpp: kvi
eav: axt ety hxj
hbw: krd flz
gaq: muz lol wnp
uze: qby
ffn: amb
dpp: mbm nfd
hsn: dne ubk
egz: vpy hwb jzm fft
rvq: axt ety hxj
hbg: gaq qtc fvk
vhh: gjo
gac: phe ikr fbf tao tnc rmy byu fxg gjm kxe ocj tjq wuc zlq
eqt: qvt dci xhg sjl
fuy: uya
tyt: ork yxz fsz kzb
wrk: dqw
efm: tio sxn flz krd
yfb: mll isc
evq: ejr mlv dtd pof
muz: ugd efs tdi
sfv: wku
ork: cet pzt
ukc: dac cyi
wrn: ein izs ved
sdh: adr
sjj: qsm
wdd: xhg sjl
evu: amm
zhv: pjt
dvt: nhw vtt lwh
yqq: ssy
dtl: rlu akj
fxg: scd
cpm: ofv ehb zjj
nvi: lui qda
kmp: qey
cet: qey rwt
xax: iya ruc xbi giw tiy
ucq: ofv ehb zjj rfe
lui: lxc sdh
myl: swr yjj
gnx: wen ubx vkx zef
cqz: ein izs
fow: pxe vlm dwa blf oxi
swf: dyf lil
xlw: zwh cbg axp
wwn: nui stf
nyr: guf gjo wmi
kpa: ugc
sat: jzj
tau: omm
ocj: qes
omm: vng gjm fxg hnh byu tjq zlq ocj kxe tao tnc rmy qzq fbf eqj ikr phe
lod: grd otj zie
vkw: gac omm lmb
lbj: dxo qtc gaq svv
sxc: kba hvl
nug: cyi hhk
uld: out
otj: omm gac
xjp: dpp uak frt
kxe: kya kzm qes
dne: qby
mbm: iaj vgg
oek: gid skw idi
yjf: ulv pzt egd
yxz: pzt
gdw: wmi you
tmg: tsb wzg bda nav xpk why zyp ktw yre ago lyl phi fbl ugm htf cxv
rgc: lix jex
vks: ymn
uxr: out
hnp: pwn
yea: hrv dqw
iox: cfy qbu mxl
qhp: out
rib: dsz yjj
sqi: dac
tfi: sfv nub bks eyy evu
owd: ntq tcn hsj
mlr: kvi knv ugp efo
yke: fsa eit
tpu: ywr yvr
svv: lol ezj
pqq: hxb dru
eit: gwi
mkf: gac lmb
gth: wjy qey rwt
ihm: hap bbp
wrs: ssy
hqo: lzu qda
axp: out
igr: bgf lup vzc
sxn: kuu
fpc: xlw
ofv: hnv wdd
qlt: rzf sat lnt
fip: gwj ywr yvr dtl
tri: eit yfb
pgm: gsg
bde: ult amt ahn dfi
obg: ety hxj axt
wui: gnx cmc wso
xoj: gac omm lmb
krl: fpc ggj
qda: mcy pgm sdh ind lxc
aox: you wmi gjo
ssy: fnm tcx eav cfk fsk vrk cat xpb ujv
guf: wnu oog qkk icd vfx fve ewm kjf
nyd: lod uoj mwe
bgo: kgv aum pvs ofu
tsb: tka
hxb: svv dxo gaq
amt: hzx drq
bpf: flg
ind: qby
ehu: axp
uxj: dci xhg
tio: zbu tpu anr
cmu: wlh vtt
ynk: ojs euv xjp
uwk: hsj
suc: ojs euv fuy
usd: fuy xjp
wgh: ntq
ktw: rkc cqu vws rgc
fnm: wwn kqv hvl kba
kqv: zli qjn zhv nui
hxj: dtn sob xax
qtc: ezj muz wnp lol
qbd: cqz ihg gve wrn
ate: tth tbr
uiv: you guf wmi gjo
jzq: sjl xhg ugc qvt
ein: ggc irl kke
ezj: ugd fqu efs eqt
gwi: nvk
qkk: suc xno
gsg: jij ojb lgz bgo aoj pqq whi aer fed fwr fko ucq kkg wzl wui cll cpm etc
dbf: omm gac
tqx: lrv wqu oek
rxq: uwk jya wgh vwl owd
evl: lrv oek
fft: hlf yyp adi mkf
haz: guf wmi gjo
fbl: mbw
ejr: gac lmb
xln: scp lil awj
cat: qdb
wso: ubx wen vkx zef
dxo: wnp muz
hpi: fus bvg
mcy: adr qby
dru: dxo
scp: dxn zbk rjr
why: tqx evl xvy
cmc: wen vkx
vky: jnb
vph: adr gsg
vws: cpz lix
atp: lmb gac omm
nvk: xlw mbl qds ehu
hrv: ytr hka
lms: idr
yjj: dci ugc xhg sjl
efo: guf wmi gjo
iyh: blf oxi dwa pxe
umd: xln
tdt: dim gth jsa
pde: sjj hkv aua
dim: wjy qey rwt ssy
frt: wae mbm
tbf: ynk suc xno usd
hnh: dah scd
umb: out
jyi: jnb bvs hyv
pvs: jdv flg
onk: jzq kpa wdd
fsa: isc mll gwi
zie: lmb omm gac
xpb: aas
yxd: rhy eak ncl tzb
dtd: omm gac
wgq: adr gsg
tet: dwa vlm
tbr: adr qby
ymn: wgq tbr
hlf: omm gac
gcg: jsa dim
ldj: lup
nhw: eyf yxa iqt qhp
pjt: xoj
hnv: sjl qvt dci xhg
wae: vgg umb
jex: cge tdt
xyw: out
kcg: amt cok
irl: gsg adr
kkg: gnx wso
bsr: trn rib myl qtr
qhl: bmk
ago: yxd pmj gzc
nav: uwe nhp kkd
rjr: out
yvr: ium
ult: ujy nyr
flz: anr tpu zbu fip
eyf: out
qgz: zbn rtr
ggc: gsg qby
dah: hnp syn dxy
pxe: sjl qvt dci xhg
khk: tfi jyy xaf
qjn: evq
tka: vwl owd wgh uwk
vgg: out
qzq: gqw ymw
ojn: jzm fft
idi: qey rwt ssy wjy
lwh: eyf
ugd: sjl xhg qvt
byu: zst vsa qbd oew
ape: pof dtd ejr
zef: iyh iaz fow ezv
tcn: bpi axl xfe
xbi: dbf
wyv: dim
qsm: omm gac lmb
dwa: ugc
hyv: wmi
khw: nhw wlh
mkx: yby gnw llp
vkx: iaz iyh tet fow
fdu: lzu
pwn: ubk jvn nbu bti dne
lah: vwl wgh
aua: vkw yzn
ywr: rlu ium
fsk: xba xmi wkr
vng: gqw
twx: wmi gjo guf
kgv: uxj
cpz: cge gcg wyv
fci: aly usd suc ynk
rzf: lus mkx jzj
wzl: hvw yjw klu
ijy: bsr orm oan
nfn: lah
ved: irl ksp kke
qca: idr kbl
ugp: gjo
kba: qjn
yjw: oan
wjy: egz jam cat riy sxr eav cfk fnm pde xpb axm sxc ojn obg fsk tcx
skw: wjy ssy rwt qey
kbl: uiv gdw
lup: khw cmu dvt
thm: kbl usz
rhy: cfy qbu mxl
cib: bvg lpp fus mlr
shu: svv gaq fvk qtc
akj: hxr
dci: bde lms thm khk pfk cwi qib ukc qca wgn nug hpi pez cib akm tsj geo skx gem sqi zhx
jya: ntq
bff: yjf ork yxz fsz kzb
geo: cok dfi ahn
fed: lbj hxb
scd: xty hnp syn
lus: jno gnw
gum: bda wzg hfd tsb xuo xpk htf ugm
xmi: uoj lod
dxn: out
tdi: dci ugc xhg
qtr: dsz swr
hsj: axl hrf
bbp: lnt rzf sat
jvx: lod
eoq: scp lil
tdk: out
drq: you wmi gjo guf
hap: rrn lnt rzf
skx: xaf kmn jyy
whi: shu dru hxb
dqi: vpy hwb
usz: uiv cbx gdw
bda: gzc pmj qmw
svr: gum oak tmg
lix: wyv tdt cge
dsz: qvt ugc
wnp: tdi efs fqu
ium: exw hxr aqb tdk eik
xty: qmo hsn
fmv: gsg
aqb: out
cbx: you wmi gjo
bfm: eoq kck xln ugl
ncl: awc
ymw: uze fmv lla
rrn: mkx lus
lrv: uxk skw
kkd: did ely
hvl: nui stf qjn zhv zli
ubx: iaz tet ezv
stf: evq pjt
tsf: jnb hyv
izs: ksp kke irl
fvk: ezj muz
lil: xyw
zwh: out
foj: azy ate
icd: fsa
xpk: onm pmj
ljx: out
dxy: pwn qmo
gjm: gqw ymw azi
htf: tge evl tqx xvy
lgz: yjw hvw swp
mwe: zie otj grd
llp: vsc
oer: usd xno ynk suc aly
xhg: khk pfk kcg tsj lms zhx cib qca nug gem hpi
rmy: gzk vks foj
nap: hbg lbj hxb
uwe: ely did tyt
euv: dpp ees
idr: cbx gdw
kwd: gjo wmi
did: fsz
yyp: gac omm
wen: tet iaz
jvn: qby adr
mbl: axp cbg zic zwh
sxr: aas aua sjj
kjf: bbp hap
wqu: gid uxk
zst: wrn gve
wnu: vla
nbu: adr
oan: qtr trn
jzj: qhl jno gnw yby
ggj: mbl ehu ffn
wuc: ymw
ihg: ved
kya: fdu hqo nvi
qds: zic
yre: gzc pmj yxd qmw
awc: kmp
hkv: qsm
wxk: out
bqh: hap qlt bbp
hrf: wjy rwt qey
zbn: wds bfm
dac: twx vhh haz aox
dfi: ujy hzx
swp: bsr orm
zic: out
flg: sjl qvt
axm: xba nyd jvx wkr
iaz: blf oxi
vla: umd bfm
akm: vky jyi
pmj: rhy eak tzb
nfd: iaj ljx vgg
qib: dac
qvt: gem skx zhx sqi geo nug wgn hpi qib qca ukc cib pez bde lms pfk kcg cwi thm khk
adr: wui cll cpm etc kkg wzl yze fwr fko fed aoj pqq whi nap lgz jij ojb
zhx: xaf kmn
pzt: wjy qey ssy
qby: fko yze kkg cpm etc nap lgz pqq aoj bgo whi
tkj: lmb omm
yzn: omm
ofu: jdv uxj
oxi: xhg ugc qvt dci
oog: sxn flz tio
grd: lmb
wzg: evl tqx tge
klu: oan orm bsr
uia: omm gac lmb
zjj: wdd kpa hnv
cfy: wrs wav jwn
fve: wax usf igr
nhp: did
eqj: kzm qes
aum: flg
iya: xwp dbf
jzm: adi hlf
hxr: out
vzc: sip dvt khw
rlu: aqb eik
xba: lod uoj mwe
ruc: dbf tkj
mll: nvk ggj
fwr: wso
bbu: wmi guf
isc: fpc ggj nvk
jyy: eyy nub sfv
jnb: guf wmi you
nui: ape pjt
cqu: lix cpz
ujy: you
xfe: rwt wjy
kmn: evu eyy
gzc: tzb iox rhy eak
zbu: gwj yvr dtl
ees: nfd mbm
vtt: iqt yxa qhp
qmw: ncl rhy iox
gvg: wwn kqv hvl kba elw
jdv: ugc qvt
jij: ijy swp yjw
amb: out
hwr: lzu lui qda
tge: oek
wgn: jyi
xuo: evl tqx xvy tge
yax: qey rwt ssy
qdb: gqg
oew: ihg cqz wrn
cwi: vky jyi tsf
cfk: wwn hvl kqv
anr: dtl yvr gwj
ytr: lmb gac omm
pof: lmb omm
lnt: lus jzj mkx
tsj: kbl
riy: hxj
rwt: cat vrk jam egz ujv riy sxr rvq cfk uzi gvg fnm dqi pde jry axm ojn sxc fsk obg tcx
swr: xhg qvt dci sjl
jno: bmk uxr
lmn: igr ldj wax
wmi: xqx bqh fve lmn zgj efm qgz ihm fci fkw oog vfx hbw tri
xqx: yfb eit fsa mgb
vrk: hxj
eik: out
tzb: mxl
